NO
SO
WE
EA
F
C


11111
   100001
101
11 1





