

SO     ./tx/64/walls.xpm

NO ./tx/64/walln.xpm
EA ./tx/64/walle.xpm


WE ./tx/64/wallw.xpm

F 20,20,20
C   255,30,0


1111111111
1000000001
1000000001
1000000001
1000000001
1000000001
1000000001
1000000001
10000W0001
1111111111
