

SO     ./tx/64/walls.xpm

NO ./tx/64/walln.xpm
EA ./tx/64/walle.xpm

WE ./tx/64/wallw.xpm

F 249,226,126
C   237,234,222

111111111111111111111111111111111
100001111111111000000100011111111
100001        1000001101010010001
100001        1000001100000010001
100001        100S001101010010001
100001111111111000000100011111111
10000000000000001101010010001
10000000000000001100000010001 
10000000000000001101010010001
1100000111110101111101111000111
11110111   11001 101111010001
11111111    1111 111111111111
