

SO     ./tx/64/walls.xpm

NO ./tx/64/walln.xpm
EA ./tx/64/walle.xpm

WE ./tx/64/wallw.xpm

C   249,226,126
F 237,234,222

              11      111     
        1111110011 11111111111111
  11    1001000001 110000000000001
  11    1011000001 110000000000001
  11    1001000001 100000000000001
111111111011000001 100000000000011
100000000011000001110011111111111
11111111111110110000000100001
       1111111011101010010001
       1110101111100000010001
11111110000000001100000010001
10000000000000001111010010001
100001111111111000000100011111111
100001        1000001101010010001
100001        1000001100000010001
100001        1000001101010010001
100001111111111000000100011111111
10000000000000001101010010001
10000000000000001100000010001 
100000000000000011N1010010001
1100000111110101111101111000111
11110111   11001 101111010001
11111111    1111 111111111111
